AStarv20
16 16 Tiles.png
127 127
.............................................................................................................*................
.............................................................................................................*................
.............................................................................................................*................
.............................................................................................................*................
.............................................................................................................*................
.............................................................................................................*................
.............................................................................................................*................
.............................................................................................................*................
.............................................................................................................*................
.............................................................................................................*................
.............................................................................................................*................
.............................................................................................................*................
.............................................................................................................*................
.............................................................................................................*................
.............................................................................................................*................
.............................................................................................................*................
.............................................................................................................*................
.............................................................................................................*................
.............................................................................................................*................
.............................................................................................................*................
.............................................................................................................*................
.............................................................................................................*................
.............................................................................................................*................
.............................................................................................................*................
.............................................................................................................*................
.............................................................................................................*................
.............................................................................................................*................
.............................................................................................................*................
.............................................................................................................*................
.............................................................................................................*................
.............................................................................................................*................
.............................................................................................................*................
.............................................................................................................*................
.............................................................................................................*................
.............................................................................................................*................
.............................................................................................................*................
.............................................................................................................*................
.............................................................................................................*................
.............................................................................................................*................
.............................................................................................................*................
.............................................................................................................*................
.............................................................................................................*................
.............................................................................................................*................
.............................................................................................................*................
.............................................................................................................*................
.............................................................................................................*................
.............................................................................................................*................
.............................................................................................................*................
.............................................................................................................*................
.............................................................................................................*................
.............................................................................................................*................
.............................................................................................................*................
.............................................................................................................*................
.............................................................................................................*................
.............................................................................................................*................
.............................................................................................................*................
.............................................................................................................*................
.............................................................................................................*................
.............................................................................................................*................
.............................................................................................................*................
.............................................................................................................*................
.............................................................................................................*................
.............................................................................................................*................
.............................................................................................................*................
.............................................................................................................*................
.............................................................................................................*................
.............................................................................................................*................
.............................................................................................................*................
.............................................................................................................*................
.............................................................................................................*................
.............................................................................................................*................
.............................................................................................................*................
.............................................................................................................*................
.............................................................................................................*................
.............................................................................................................*................
.............................................................................................................*................
..........................................................************************...........................*................
.................................................................................*...........................*................
.................................................................................*...........................*................
.................................................................................*...........................*................
.................................................................................*...........................*................
.................................................................................*...........................*................
.................................................................................*...........................*................
.................................................................................*...........................*................
..........................................................************************...........................*................
.............................................................................................................*................
.............................................................................................................*................
.............................................................................................................*................
.............................................................................................................*................
.............................................................................................................*................
.............................................................................................................*................
.............................................................................................................*................
......*.................................******************************************************************...*................
......*.................................*....................................................................*................
......*.................................*...******************************************************************................
......*.................................*...*................................................................*................
......*.................................*...*...**********************************************************...*................
......*.................................*...*...*........................................................*...*................
......*.................................*...*...*...**************************************************...*...*................
......*.................................*...*...*...*................................................*...*...*................
......*.................................*...*...*...*...******************************************...*...*...*................
......*******************************...*...*...*...*...*........................................*...*...*...*................
......*.................................*...*...*...*...*...**********************************...*...*...*...*................
......*...*******************************...*...*...*...*...*................................*...*...*...*...*................
......*.................................*...*...*...*...*...*...**************************...*...*...*...*...*................
......*******************************...*...*...*...*...*...*...*........................*...*...*...*...*...*................
......*.................................*...*...*...*...*...*...**********************...*...*...*...*...*...*................
......*...*******************************...*...*...*...*...*............................*...*...*...*...*...*................
......*.................................*...*...*...*...*...******************************...*...*...*...*...*................
......*.................................*...*...*...*...*....................................*...*...*...*...*................
......*.................................*...*...*...*...**************************************...*...*...*...*................
......*.................................*...*...*...*............................................*...*...*...*................
......*.................................*...*...*...**********************************************...*...*...*................
......*.................................*...*...*....................................................*...*...*................
......*.................................*...*...******************************************************...*...*................
........................................*...*............................................................*...*................
........................................*...**************************************************************...*................
........................................*....................................................................*................
...***********************************************************************************************************................
..............................................................................................................................
..............................................................................................................................
..............................................................................................................................
..............................................................................................................................
..............................................................................................................................
..............................................................................................................................
..............................................................................................................................
